000000000101000000000-
000001110101011100000-
000001010101010100000-
000001111101111100000-
000000010000010000000-
000000010000010000000-
000000010000010000000-
000000010000010000000-
000001111111111100000-
000001010000010100000-
000001110000011100000-
000000000000000000000-
000000000000000000000